%%%%%%%%%%%%%%%%%%%%%%%%%%%%%%%%%%%%%%%%
%P        %        %        % %  %  %  %
%  %%%%  %  %%%%  %%%%%%%  %  %  %     %
%  %  %        %     %  %  %  %       %%
%  %  %%%%%%%%%%%%%  %  %  %  %  %%%%%%%
%  %  %           %  %  %  %  %        %
%  %  %  %%%%%%%%%%  %  %  %  %  %%%%%%%
%  %  %  %                 %  %  %  %  %
%  %  %  %%%%%%%%%%%%%  %%%%  %  %  %  %
%  %  %  %  %     %                    %
%  %  %  %  %  %  %  %%%%%%%%%%  %  %  %
%     %  %     %  %           %  %  %  %
%%%%%%%  %%%%%%%  %%%%  %%%%  %  %  %  %
%     %  %  %        %  %     %  %  %  %
%  %  %  %  %  %%%%%%%  %  %%%%  %  %  %
%  %        %  %     %  %              %
%  %%%%%%%%%%  %  %  %  %%%%  %%%%  %  %
%     %     %  %  %  %     %  %     %  %
%  %  %%%%  %  %  %  %%%%  %  % %%%%%  %
%     %     %  %           %        %  %      
%   %%%  %%%%%%%  %%%%%%%  %  %  %  %  %
%        %        %        %  %  %  %  %
%  %%%%  %  %%%%  %%%%%%%  %  %  %     %
%  %  %        %     %  %  %  %       %%
%  %  %%%%%%%%%%%%%  %  %  %  %  %%%%%%%
%  %  %           %  %  %  %  %       .%
%  %  %  %%%%%%%%%%  %  %  %  %  %%%%%%%
%  %  %  %                 %  %  %  %  %
%  %  %  %%%%%%%%%%%%%  %%%%  %  %  %  %
%  %  %  %  %     %                    %
%  %  %  %  %  %  %  %%%%%%%%%%  %  %  %
%     %  %     %  %           %  %  %  %
%%%%%%%  %%%%%%%  %%%%  %%%%  %  %  %  %
%     %  %  %        %  %     %  %  %  %
%  %  %  %  %  %%%%%%%  %  %%%%  %  %  %
%  %        %  %     %  %              %
%  %%%%%%%%%%  %  %  %  %%%%  %%%%  %  %
%     %     %  %  %  %     %  %     %  %
%  %  %%%%  %  %  %  %%%%  %  % %%%%%  %
%%%%%%%%%%%%%%%%%%%%%%%%%%%%%%%%%%%%%%%%