%%%%%%%%%%%%%%%%%%%%%%%%%%%%%%%
%P        %        %        % %
%  %%%%  %  %%%%  %%%%%%%  %  %
%  %  %        %     %  %  %  %
%  %  %%%%%%%%%%%%%  %  %  %  %
%  %  %           %  %  %  %  %
%  %  %  %%%%%%%%%%  %  %  %  %
%  %  %  %                 %  %
%  %  %  %%%%%%%%%%%%%  %%%%  %
%  %  %  %  %     %           %
%  %  %  %  %  %  %  %%%%%%%%%%
%     %  %     %  %           %
%%%%%%%  %%%%%%%  %%%%  %%%%  %
%     %  %  %        %  %     %
%  %  %  %  %  %%%%%%%  %  %%%%
%  %        %  %     %  %     %
%  %%%%%%%%%%  %  %  %  %%%%  %
%     %     %  %  %  %     %  %
%  %  %%%%  %  %  %  %%%%  %  %
%. %              %        %  % 
%%%%%%%%%%%%%%%%%%%%%%%%%%%%%%%
