%%%%%%%%%%%%%%%%%%%%%%%%%%%%%%%
%         %%%%%%%%%  %  %  % P%
%  %  %           %  %  %  %  %     
%  %  %           %  %  %  %  % 
%  %  %  %  %%%%        %  %  %
%  %  %  %  %     %           %
%  %  %  %  %  %  %  %%%%%%%%%% 
%.    %  %  %  %  %           % 
%%%%%%%%%%%%%%%%%%%%%%%%%%%%%%%