%%%%%%%%%%%%%%%%%%%%%%%%%%%%%%%%%%%%%%%%
%P        %        %        % %  %  %  %
%  %%%%  %  %%%%  %%%%%%%  %  %  %     %
%  %  %        %     %  %  %  %       %%
%  %  %%%%%%%%%%%%%  %  %  %  %  %%%%%%%
%  %  %           %  %  %  %  %        %
%  %  %  %%%%%%%%%%  %  %  %  %  %%%%%%%
%  %  %  %                 %  %  %  %  %
%  %  %  %%%%%%%%%%%%%  %%%%  %  %  %  %
%  %  %  %  %     %                    %
%  %  %  %  %  %  %  %%%%%%%%%%  %  %  %
%     %  %     %  %           %  %  %  %
%%%%%%%  %%%%%%%  %%%%  %%%%  %  %  %  %
%     %  %  %        %  %     %  %  %  %
%  %  %  %  %  %%%%%%%  %  %%%%  %  %  %
%  %        %  %     %  %              %
%  %%%%%%%%%%  %  %  %  %%%%  %%%%  %  %
%     %     %  %  %  %     %  %     %  %
%  %  %%%%  %  %  %  %%%%  %  % .%%%%  %
%%%%%%%%%%%%%%%%%%%%%%%%%%%%%%%%%%%%%%%%