%%%%%%%%%%%%%%%%%%%%%%%%%%%%%%%
%P        %        %        % %
%  %%%%  %  %%%%  %%%%%%%  %  %
%  %  %  %  %  %  %  %%%%%%%%%%
%     %  %     %  %           %
%%%%%%%  %%%%%%%  %%%%  %%%%  %
%     %  %  %        %  %     %
%  %  %  %  %  %%%%%%%  %  %%%%
%     %     %  %  %  %     %  %
%  %  %%%%  %  %  %  %%%%  %  %
%. %              %        %  % 
%%%%%%%%%%%%%%%%%%%%%%%%%%%%%%%
