%%%%%%%%%%%%%%%%%%%%%%%%%%%%%%%%%%%%%%%%
%P        %        %        %      %  .%
%  %%%%   %  %%%%  %%%%%%%     %   %   %
%  %  %         %           %  %      %%
%%%%%%%%%%%%%%%%%%%%%%%%%%%%%%%%%%%%%%%%