%%%%%%%%%%%%%%%%%%%
% % %         %  P%
%     %%% %%%   % %
%%%%%%%    %%%%%% %
%.      %%        %
%%%%%%%%%%%%%%%%%%%