%%%%%%%%%%%
%        P%
%  %%%%   %
%.        %
%%%%%%%%%%%